NO ./utils/textures/Untitled.xpm
SO ./utils/textures/untiltedSO.xpm
WE ./utils/textures/UntitledWE.xpm
EA ./utils/textures/UntitledEA.xpm

F 117, 109, 102
C 46, 45, 43


111111111111111111111111111111
1S1111111111111110000000000111
101111111111111110111111110111
100D00000111111110111111110111
111111110000000000111111110111
111111111101111111111111110111
111111110000000000000000000111
111111110001000111111111111111
110000000000000111111111111111
111111111111110111111111111111
111111111111110000011111111111
111110111111111111000000000011
111110111111000001111111111011
111110111111011100000000000011
111110000000011111111111111111
111111111111111111111111111111
