NO ./utils/textures/NO.xpm
SO ./utils/textures/SO.xpm
WE ./utils/textures/WE.xpm
EA ./utils/textures/EA.xpm

F 147,93,246
C 229,111,248

1111111111
10S0010001
1000010001
1000010001
1000010001
1000010001
1000000001
1000000001
1111110001
1000000001
1000000001
1111111111