NO ./utils/textures/NO.xpm
SO ./utils/textures/SO.xpm
WE ./utils/textures/WE.xpm
EA ./utils/textures/EA.xpm

F 145, 140, 140
C 99, 86, 86


1111111111111111111111111111111111111111111111111111
1001000000000000000000000000000000000000000000000001
10S1000000000011111111111110000000000000000000000001
1001000000000010000000000010000000010000010000000001
1001000011111110000000000010000000010000010000000001
1001000010000000000010000000000000010000010000000001
1001111110011110000000000010000000010000010000000001
1000000000010010000000000010001000000000000000100001
1111111111110011111111111110000100000000000001000001
1000000000000000000000000000000010000000000010000001
1000100011101000000000000000000001111111111100000001
1000100010101000000000000000000000000000000000000001
1000111011101110000000000000000000000000000000000001
1000000000000000000000000000000000000000000000000001
1111111111111111111111111111111111111111111111111111