NO ./utils/textures/NO.xpm
SO ./utils/textures/SO.xpm
WE ./utils/textures/WE.xpm
EA ./utils/textures/EA.xpm

F 143, 118, 109
C 76, 84, 85


 111111111111111111111111111111111111111
110000000000001000000000D0000000000000001
 101111111111010111111111011111111011111
 1D1        10001       1D1      1D1
1101111111111000111111110001    10001
1000000000000000000000000001    10001
1000011100000S00000000000001   1000001
100001000000000000000000000111100000001
100000000000001D1000000000000001111100011
10000000000000D0000000000000100000111101
1000000000000010100000000000D0111D1110001
1000000000000000000000000000111000000011
111111111111111111111111111101100000001
                           101110000001
                           101110001001
                           100000110001
                            111D111101
                      1111111110001111
                   11100000000000001
                     11111111111001
                                11